NO ./textures/colorstone.xpm
SO ./textures/greystone.xpm
EA ./textures/purplestone.xpm
WE ./textures/wood.xpm

C 173, 216, 230
F 144, 238, 144

1111111111111111111111111111111111111111
1000000000000000000000000000000000000001
100N000000000000000000000000000000000001
1000000000100000000000000010000000000001
1000000000100000000000000010000000000001
1000000000000000000000000000000000000001
1000000000100000000000000010000000000001
1000000000000000000000000010000000000001
1000000000100000000000000000000000000001
1000000000000000000000000010000000000001
1000000000100000000000000010000000000001
1000000000000000000000000000000000000001
1000000000100000000000000010000000000001
1000000000000000000000000000000000000001
1000000000000000000000000000000000000001
1000000000000000000000000000000000000001
1111111111111111111111111111111111111111


